año,unidad,renovable,térmica,nuclear,total
2010,MW,10604,16818,1005,28427
2011,MW,11143,17793,1005,29941
2012,MW,11291,19024,1005,31320
2013,MW,11347,19091,1010,31448
2014,MW,11388,19351,1525,32264
2015,MW,11390,20443,1730,33563
2016,MW,11452,20764,1755,33971
2017,MW,11499,22896,1755,36150
2018,MW,12252,24531,1755,38538
2019,MW,13404,24560,1755,39719
2020,MW,14834,25362,1755,41951
2021,MW,15836,25398,1755,42989
2022,MW,15897,25275,1755,42927
2023,MW,16581,25437,1755,43773
